0222221220210230202230022221102202302021102030202122210220221221002223022221002222230203022220122011
0221012211112222310211122211202310223212311103121100232212122101110221121012321021011110321023221111
1011122123030222122303102212130103021010121230031231022111221113123103212322211212322311021211022321
0331101101103022302130301031223103103111223011212211211231021230302121030222210310101032312112110211
3023033112321101021211231202301130321131022312303031112011103022232231103022112231231102222321231111
0302301121023132231032103230112303031212302110210312122303123101020223230303232012303111022210222311
1222312232301221023210302203121210212210211123032102301030302331213022211010220322210311212212223031
1022102202130211102231230110212232122232112211121121032311030022110302323123023022112112122122222311
0310321121223032310110223131122203120122121223103111101212303301311202210301121021121230221221010031
1211023211201210111111101211022110303221303021101123231023021032032112122233211101231022011212311211
2231210032112233111111112111223232230223010312311102011222211122302310221022231113011301311021112123
0223111102322221111122112230101020030222331101031121132222131221032112211221210310323032231122121101
1022211110101221123212322123212311303022223032231031222021210112300322111012111032221102223212231131
1102123311232212221110221102122212223101001121021211201212123210112021231121103201011112022110103221
1312222231202310223123011211212212102313113023120312112110222311321103023102321033123110303031230231
0122102212110232212102312122110122321010322301211023121111102112011103101123011222302323022303012211
1221032122311022121223011101323201023321022312231222303312121230131130331222311010230222110120310121
1023221001212223112210323111022131221010301030103022210230311023103223002102231123032101111212323211
3110211112101102301030221112301211023111032311110302111221011201322221321112012310102311212122222231
0322311311112311031122211230232230301111102223111221112211132111020032103121322023030232121210222211
2101032032210112211221032212222112111111110221111023101032302332231302212232101101231221122311022231
0311102302131101232023110222301101231113131012311102311210110222210230130100311310223021222233102103
2231030111103132101210232102232312112321210310230330233031231021031031103231032033021121101020311231
0211103231231101111112100321021031212012230311223011021103203103122303230231221302303212312301030221
0111122212221111111221311012311100322322123032221123121121032110302230222023032221030230223031103011
1123102121011231112212231120231113020223101201023221212303021131030213021212102123122212030323120311
3210310312310103030112103211023102230221232131102023010121211203222310231122121221220122303021212111
0232232230231121023121230232302130212232022023101302331212112121022121023021111012213022102301032311
1022102222223303101231023021111212121021301301132122223121121111221213211212311322221301122313102231
2221110110210231112023102311122122311103031031222101222103111122212122110322112221012212302121230303
0213123112123022301301230103023122012320301110221112222122303210110302311010320212321030231212222121
1222223211110302132232203121101222303013033211223110203210310311123022032321203223023232120122221211
1022102223112121102102231111212210230310102232102312121030111031102301302212210221022210303120230123
1211232210122211232110030312120311103031310302310031212323223223102312230321032111222123221223013221
0321020211301032221231303203213032112212111030233103031002221021110230212023223111021102210102310211
0031303212231210212102230030121101122122111103022302320310232312312223121222102303230311033121123111
1102230122303123023121013103103232230302321110302121013030222023030010101222121110212231102211222121
3223011222112021102303120310321022023022303232230312322311021101103113113021223112110101032212221023
0102323101121101110122303032223101301302230220223002221103213232330322110312120310313032302122231221
1230202311223313123122103110210232112230212103030322110322122021011030323101212111221102111222223031
2212310230300121030302310302311021232102322110223011123003220321111222122212110312111112312202210223
0110211012211223103022111211031103021031021312120311221122103012323021222130111030321230122123031001
1111232310111022310303212121223112211211111031212102303211231122222312101223111110212223221021103113
1212202231112320112110121212212122112121112302102330120322101222102023232101110302310110211303121321
1230120303112011121031123030121211231213102121110221223021232103112302102332312110231232123031012101
0223213023110313211303221101122110210122330031231023021212222321122121112022231112103010320302303231
3021030302323030211022031131221232323010023102303102310322210211101223122302110330302312211222122223
0322303110210303212301301223031022221123210321031112012222231211112221002112212212120301032101122023
1022022111030230130032232202303210031222110303211121321001022121122111312230130122323033101111221101
2301101311223011103302221030122233212210313030231032210311211111010231010223103022222102312312223231
0231312112110311122121023231102220210112110311030300112111023111110303111021230302102322230121022223
1012232232211211221031222211121023113121311011212111311113110303111030132303032121110222221303022221
1121010222112123012103101031031110110212112312122112230322231110331123022102301123032110012231100301
1212312211123210322322111103223103223221103023101110122102223112223101301230231021230303110012231031
0311021023102233021022312110110321102211121102311323221310201112011111032222231212211030311110123103
0121213110310222231220321123112102311033212122232012103031012322311232300230223102311231031123222311
3211121031031030222031023221121130231222121102301122110311130222112202131011010230112223103212203031
0231031103222303101103120031103223022210303210112302323011223221122121221123303031210221120322102321
0223101122221032032321103303120222121032232231230122221123022223210303211222110303031211213010322221
2212113102103101202303110103211021212101022103011210103210222222123210112110311030231012230323012011
0321121032310112130110311110232311121232310322112123203032230101202103101111221103012321210222321123
1011212302233111223211211232210303011210211021312230130302223112230323112312103130321012122211023211
0312120110101121022131011210112222311011011212230223223030301122103201122230311211211121221121120311
2301103111231223110303132123122221231131132122011202222301031222310230301011221031011212211103211023
0233231123212102303030222102202232223103101221312110122033212222232123032312111223111032123032112301
2102222320230310310303021122130202230231112212101103221102112210201201210222312120132320221102122231
0121020211011012211031031221103110212121230322312321211030322112112130112302121211220223103232101103
1031301223123122123023103011112123003102210221032022231303021122311103322223100312031030110221110321
1302233022310301212302321322110101130301032112301103010121111222111102203022311031103211112111233011
1031022310211230110232212212303312303031102302231230313103112222311110230301211110322123122311022321
1103102303032213112222102310110230111103311022122223022310320222230331023012233121011221222032302111
1121121031222222310221120123111023231122232211222221302122212102122221101310221212310230101203021111
1221211212210222212103211221112310102300222103022211031221030312222103112111011031031011232102303211
0303030322112101230322232111230223111032103110301111122103102121203121112211112301121113021112112211
2121101021121232223022222232203010311121102332110310302110330211010323101112321230223122303110110131
0231131031101201010321010222110311031211122102311032231112210111132222331110112213021110230321323103
2223212301232112312211123030303231212211221230213221010310233131202122023111102110303111203103021121
0221030232102321031031122221230102322123023103122223311031022103032222302323110312110312112211103211
0112301222312203101121210212101230210301210121220110031112302312222210030222233030311202322121120231
3100312222122112233102123121033011123212033212223123221121032121022231223022210303112112021103123011
0313030121102310102232122211102323220032302102223210211211221011221221010321031221030321112321102311
1010321211122111230221222111322102101302101102102123032311022331010210332211212223211032301013122123
1132211031101122231011021212102230233031131121223003100232101021113033022122120222111102211110102303
1221031203231102223111103223223013022321103212210330231021231213121202301222212102323230112323121021
2103122130212232210312310222222321110023230230132023013111103122212122232102121121020103230030311231
0301221103122100211101111021201212323222031221221211122303222101223210302312213211103110031103212101
1231010320223132111112311122232221202221212212212123101030221312210032222121102231311231103230021111
1012323023021210131122123102221103031012102122110302111211032112223302211211030111031011110223123231
0322210301212111103100222322211030211121110223231101311123022322222121031031303103110323112230302031
1022111032311231310311022222231123030311032302223212231011212010101023122212111102321022122210121103
1211123210230201031031100302221222310232302110210130223102322323231101022121111130211212230233103121
1031210231023111023123231010213021223022121231223211210130220222211311223103231223032321012101230103
2302111023210313102301023132121032021121032210210323011102303010232112210322103010302210321232211311
2111221210221010321032301201112301303103221033032202131230121131021111031021210323031031012222121031
0321013033011131011210110313102112230302211101010111223023221222123231122212130221203102330221223221
0223122301113103112231231030321322223110311231323112221222213012302201222111212101030321023011010223
2101100112320310321101011212212012010223010231010322102300322310223031022322310311112213120311123021
2312311230213030111112311120310321322302312223110120322112221032102311210210232113102122303031122213
0122112103030323111230111011031031022110312010313212221230221203112222323111023121110320231103210121
3222323223222222322223232332223222322232222323222232222223222322322222222223222232232223222322223223
