20212010203020302021210201022021020230222203002121
03110331122312230322231033101211112223003030321221
11023012101220212222103210311111221021321212112103
12302301112221222302321031032310303110221121211111
02230132032223010110223222302231032123012302121123
20303101301022311211010121030223102102322232303101
11032232232302311031123221212102321122222102121231
03210222120102111103110103111122103122221223102301
22123021011310121312123222310301121210211022303031
03110303312211231030302222232111223123121222230303
21111110110132211122122210222230302222012221011221
03211223211222103221010233021011030101120231312111
10232212212121121023311022231123211311232103010311
12100322111101213210211110103222311032221022132103
10233022321230310123112311122222221222211301301111
03010102122231031021030011222210210230231032111121
11123111222103223103123132212223113023102302312311
21102321102310210303102302122212030301230122121103
11122103110231212130322030212121211031023221203221
11212310323222121102221303022303111112301012110213
11030232022221123223012230230230121203032321130321
11222100301023220102310222301223211030322220303011
23011132113122023321111022113022123212221011030311
02312222301102302223113110321121221032212313103111
01110102132230102210110311201212011102110110310231
11123212221011122311231032110321311231111231112223
11102230212323222231203021111023032003032022121021
31230222321220110223032212313121003110301301211111
03011003023023032212221121222212301112112112132211
02311110310221102122223012221122131110311231221211
11031132103011310301010300231022303112110202232131
11222302321132232232311031011221210321112322210303
10210122103202120221031213111011031023122210111221
12311221122231210121223122111122103101221123122221
21011222302102113012221101311301312312223201221221
12311010231130121310210311011032110110210231212213
02112311012223232211033031112303111110123012120121
12321110322221022231221122322110323111210322023301
02211110222232222302303102212232222113030301302231
22112113021022210230121212110203022321213032230303
22310322232221122211212102322121102212210321022111
02103010222211210132110330221212302302311021103111
10322332210112111222311023031230110110231013210321
11202222111232112201031121012211231123011320112223
12231010312101210131212212302322111210311011122101
10210312110311031223121122210211211211031111201231
03031122311031111101011100311030232123211112312211
21112122212303231112311112231212301210232310232231
23103210121122223032111223023110112231021031022223
22322223223222222222322222322223232222322322222223
