0220210223
1031110101
2303033231
0231101011
1202232321
2112101031
0322311103
0220231031
3012303101
2322232233
