0302030022221222201022220222230012022100023022210100300221222021002210230222030102220222210302023021
0230303222112210231221103022211122310311102302323232112112221103310111023201211110103010232221210301
1103031021102123012211030320323101011111322101020210321122032310033112222130111231110131022111031111
1122303122323222320231232023010331123031022312303032223102300303301222120301312211233203103111103111
1201221222101022212223022302310211221231120232112301022310232230232103212231023031022122302303232113
2232101023111212122102322112111030222211212022310231210122302103210310230211210232210302230310221121
0023231101230321021110221121213103012110110301011102123102231232031012122322321022112110110232211211
1101023112212211031230111212102311121213111031132121102122100222303121210222211210323123111020232211
1231101122103011302211122221130111112122111103022303112221231022111212110110111032222310311231010231
3023231222310331030233102111223121121110313112210232322120303212230231233121233102122031011023123211
0300231022212223212221121123001123103112122322131010011213031030122120221212101230301211112303221031
0232103102112022101011023210311221110302221201211123122122303211211211012231112223031011102030211101
2121121230322302331311101123032231211223012233030321101222102123032223121202302220231131301303123113
0223212223010121023031232100302212232222321021212221111010323221102221112121230213023012112110102121
1102221022323212302103021113030103010222011211032223112331022103112012321211023030301122323223231111
0310231102211032110122303122303122312211130312320222302223211210121120221111211121013212010222102231
1030211222111101211302232302230302120311212230023022230100032031211303012112231223320321123102323023
3112123021310312132112022110222230223032121011121221023311301231032102301310202101011023110110221021
0322222311032231022321210233022122102302232303212103022232112211302330131032112231121221103231023303
0221222011120210302223030302301210310030222121030311022302310112222203223221321012311032322101222121
2112210331103032110302123030231031111212121123102232301030111322212230222211023110222300302312212221
1221031012311102312223022302123122313010303210322210110303111002310103002323101322230232110230321223
0223110321010321122101221230301222210311021031003031231031112322223231122222112210103201231022212221
1102322303111031023232211021031022123231212223121101023110310221021102320211232123122231203230221011
2310222121110303220201112303122301221011030211103111102302231012311122212121202211201012110211030331
0231021211113032013012310231221213022323303030321111112121023122011022121012121110113103110123211011
0223212032110302122130112222112122221021023112031131121011110302311211211321103223122321111102103111
2100321101122230301303121030301221013112302322301223103111122311031032112223102210302212313110330321
0311023111301223032121031012111212321102121202232203112323220231103222120223130231222130121032103023
1211122312112221101223223122311010210330230110222130322210103011121101212222103222102303211102310301
2113210111230032332220101101212311212221013112101023210121223112231110310301120212122030103320112131
0300123110213201010211130311030232121223122302311210231212301121023031032111212121221211122213121221
1231101232122232311111212231103021112101100311031223012121031121201212300312112231203231110102212211
1023232221021022123112121023111122301112312111212222321102311212131121232111122212122223123230130231
2321002111103101221122311222311221112311031232122101012310122231223022210111210230302203102211212111
0223112231311032211010212101112031121031122200110312312211220122021102123110111222111030312223030303
0210310212231030232132103231121103203101222131212230122131013101212321221111112222311212102211120123
1031123121010303022301120231103122121132022223030121300303102312130223011311121102030231121031211101
1211022212323030301032312223221003103021301021223203031030330231212221110223111111212223123110233231
1111010310023102233212201220120330311112232303022110303112212102122223113010311222322210302311220221
2111310233221121010121031023213010111220302102221132121221121103011022310312211010210212121012223011
2312231020211213123212311102222311111023031110213203212212211110311221031030112311223223211322010323
0202211231102322022320031123012033111110310331221030230112112331030211223123230231021022230221322301
1230131011030221301003303222321222312211011012212301013122110023223111023222103101101222111031022231
2211223123103012231110230222103001110131123110230233110302313210102231222220310112312110311101221211
0231020310310312102331101101232312123223210321023022310222321031232212210211031230121212121113022231
0103232122323121223011231112202231222210230211221110233022103111020100322311111011231023211121102103
1230021210202211021123023121121030222232123032231112222302110111111233022232312311023110111012310321
1221111011110132301221101023103102302221221022011220230110313111231022301002302231212111232312110223
2213111131123201032303231210310223030230231301112223011231030322223100212330110220321231202122313021
0122311103102231222122223121032301122211022231310221123211103022101112130223113012011023031102120311
1223023112111023010302222203210111222031110212211031220123101211212323103010121121112322101101212231
2102300322111102311022302130111231003101212121231011013102312112110221221311303211121002313111122221
0321031022311230232310230303211212322312311112211123102310110121111103012232222231121310302331100303
0223230222310103102011103030111021220322121120111101110231231211231122310210221023212231030223112231
1022210302231230230311121103312311012021223211323231111103023232211200112111023122030021223002322121
1210231030211031211111031122211023122312210032010103131103221021032131122323122222303112210310003103
2232123112123022231031103222111210301022111301131230303230212301203103221021102102230303031011130301
0201222321221223023211110102311031213101232231012110230223030213030310103111230321023210303131223231
1111021002212101122211223112223210120232101011101122221010303030303031110312112211222121023212210211
1113112322111231010132221230222231212301312311113222213110232212112211123023101032103213030120231031
2121221102321023123222032223201212110112121203300302122313022121110231110221113122230122303212223221
1110232110031122222203202110032103123230112130131023222121212213123023211011101101023222110322221023
0312222313221222100310230303221121102221223223010310202212110122221021112311111232302110311022211223
1210222101012221130231023110103212302211021021112212110121123210211211223031132021030232032223011021
2031003112321011212211121031110310130231102311310230331211102122313031021103222303011101120022311111
1103110322103303030311211111232123023223110112230230211111231222210312312322221032312111223102132031
0311112101310123211031032212120302302221131110223013032110223003032221102202301210212312212312221101
0312321232123010231103102130303030321203221112110310301113022301110223110121032312130110322110111313
3030211001221111222321111103222210032122213102311110111110230112232212231023202121223110010303112121
0303031111211112102223231101021031101210121122031113231122303121022122223102123022222113131110303103
0230302312231122310220121132303213112233103110303122212302231213110102021121221230101310303031021101
1103121122223221212111223222111030122101112122322210210110221121031311103111212223232230231103303131
1110011220212212231112222003231023230310322102222232111231032112303031130312101012001023203122121211
1111132210122230203122011130010302223011022321012102311003222222122303103210312321311210110223210111
2111210111102222321101121223132122122311221012321110131110221011110210322211101211032111111022111321
2311123113102211023112321011201221102112302323022311223132212311122312220231032122322311111122231023
0112102121110121102310212322310303230322230102302211202210231030302210213023221222222231231222011221
1110312303231211232223010221031030211022103232122132130112101212110231122302031001002302222301310223
1232122232011112221022312103111213031221112202301101211230311030312103011031103313122232210231031201
0101122002311110212301023122311121012211230230230312221012113111021110323121110210302100111031012131
1231221310111111030033110320231211300323221021223030213122310303303112022211112111010331231103311101
2303203031311223101301112103023032112020223213021211110301103222230321302123121131312223023110231231
0230122310112103112232211122202302311213022121211031032231030221023212230302103022230222310232212103
0223102123121102321021223101230110112122301030312231022223121011222212012112311210223022212222230311
2301223102232311023103020312223231122222113212231023102212223131023022321102230232110310022210101031
0232221110210112110322311030010223302003120120221122321122101011010302213122122023111031301223111103
0211012311123121111202223123123022121130303211203102210230331123123030321122221302311012112212231121
3030302212121223212122103221022230231223212212110312123023021122110303023210212121023121232122103101
0311030121222122111212230223302101023100210130312121102300311221212102300232111103122302102102323231
0123023212223210322122212122030313221031031211111031110231221211223121211022310311101032230322101023
3221210322222231022221103022303220223303112123121222112211012232221212111210232112231022103101232303
0210112220222021102211110301222212222231101221223012310232322210212230313031010230111223112032222201
1033110212101231112112303112221222222103033021021122232210100123121023010231323023122222321221030131
1222323032312212121222122121212122003122301111211202122213211102112302323012222221221201023012303103
1201021102230321212103103212101101122222230322112110302122131032121030102310222212211033210122230301
0112231110122212121122110111131111230221211021110312221121103301212111230232021121031010233110012131
3110103123221030323201121111211112103012103103311030211211102232121111212101231011111111022303123211
0313121101011103202131213223031121111121130321031231033030322223111232102312211123231111110231210121
3222232232323222232223222222322223232232223222322223222322222222322222322232223222223322322222323223
