0202221021022221102022100222301022202100223002100122222202211022030022110030201202102222222222210301
1031012311221031230302332222231221032131022310331222221010103103223101211211112110321001012022111031
1103110212223011023030222210211011221211122112212210211131130320223232131123121232223312321110312301
3101111120110323101103222123111122303111222112222113032103211010210023223021211021200230222303121031
0332311031231010313230220230232211030311021122212110302321112312123222222211031012131022301112031211
1002030303011112102203023023021223102111212322121232210111102321102201022111211321203221031022303031
1121303030312322303031221210322221123112121021012222123211122031123031120312231023110211111210232111
1301031223121002130300231030212212302310112312322102310231011223210303212121023012032113112112210311
0113100102032312223231023213030211022231210122210310223023121012211121121221102321223122301122312111
1102331123220320102212230230322103101023023220231111022320312322123203103103130212102300131222230303
1122203222211013220322212211002330311212301223022311212012103003222122110311212121222131210222103031
3110230120311121013010210111122211032110232222303032121122302322201221110122122232201223123010301103
0322303103031103120323211123220312302311021001021101303122030221113011111210302102111102222312131121
0222230310303122311022131202213002310032303311031232121221101222321123312322301230331031022121223221
1022212112101221203221222321110330111102232031301023223023231022211210121022131023203120302210210231
1212122301130032122231102223023023123121022312231222202122203101222311221211103120231211121031121023
2121222013211101222222321102230302110312310101012210130102111230221032112111231223002310303103221211
1112221110231112022110223030223032111021223212322111211310303013003202321112210201122113030310211031
1102103131031223103212102311101221231122102123021123032232130322330230212110103111101110303110311221
0330321103203022302230310111030232211101110302303201102221103010212103121123122313112323121123031011
0223023122111103030212111211232202123111231031030111121103110311122321103301202122302222223221121123
3010302221121110303021123232102123202312211121023231223030303123021023122232123202110212200221213211
0323101011213111223111102222231222110222311212301102223121110211011221010203102130310122131103122231
2210231132122311022311121022212220322230112210231230221103023032312031112110312223113021223030100301
0231211221023023021103011210321012222223122130301023012301301222110303110323010212121232110303131031
1023012212301221303221131112212310222221101023033110321032112210312312311010323121032210303032212231
1222322122232212122213223122101112222112311301101122212321230232110110231312202231102123110101210211
0210102212221023222122202102312312201100212232311211032012011023111232103023030103230211031312123031
2111110122101221003210112320230102111131230222232111100321311202231022312022303232011223110110301223
0323111221232230321031110223023130312223011202210311131103012130103102121110110022310101103112112221
1021131031022212303203232121122223111022312130212231203222323103230230111211231221213112310311112031
2303223101220322110230102223210212211222121103030102230221021110210231211031222032122312231031230301
0110101112231022303211222102112110122302311231213222211221012123111023031032221301222122210320221031
1231032121023221222031101310310323102121030300322210112211301022111221303302210232021030232213021103
2211301212322212212303112232211210311211212232222111231032111301312231030032032301031012102122123121
0230231122222102110112110222112112122123010222101112121212131032121011213201102231303122311122302323
1202231030221110311122111210311101201102323201231112221121223102112310310131232212231102231102110221
2130223212103231123221112112103130113101022113023230122231022311121030111223100223021231003230312103
1223030010322222222212321121130303322331012210301203210103221032221211112101032222230023122211030321
0222303112221021010121031211103010220223121111212232111210223221102313102311101011011101102123022231
0101030330211212311232102121230131012212303232102221211212221011230101230132032303123112312101230211
1232301022321121032221112212121223122122102221122212110130212131023111023221101210301121101232223121
2222113211012211101012121221211022321210321211210230311223103101210332302103312111031303031010120303
0302310111122131232321212213033210022123012230311103112221122312111022111110223112312121112323210231
0122123231221210221032102301120111103100321003031121110211012110312301231122102321023103220302232221
1030302220303032303010310131103231120331203130312111111212322311110232121221310031101110013030222111
3222230223031101032311031221230103211012122103030311112122102231110101210212111303031233122321030231
0210231101211231022111212211211222312310301321103011222301110223111232112321111031111002302223022303
1030220311030223230303031032231102232110232211030332012211111002311023110203231101112321022221302231
1123013031211022223110223102223121010313020231121021322113230330231101111230101132223011222112230021
1222321103031021100311102322210111112030303023223102221122211023023231123023231101022312102320123011
1220231120321231111031122010231112321212111221021110111102111101100221222322031112302121112011101313
0210211213012211111111210332103030103030310031122311122310303231131011012020301112111223110323112121
1032303010311023211122112101110303231103031303210131101031211023223322302311031110122222310110312211
1222110131032230132212230112311030301231203030031103112232111210222212230121211111222222111103021121
2101123303222103102121023310231102210223030303221230302301110123022122223213033231022101311110311221
0313222230203121231212102121013130130222303223012212110230323210303022222121102221121232111112111011
1030222222110231201112311223122103212222322222310311112103022132121101022303222112302211233121232311
1202230222312210232122230221212312110222222210230111110321221222223111102122211102110310222312210111
2130223002321123021120212302310121123030021123031231111011211101021112232210230301032223001220323231
1103011110031102303223220230111223022223211021222223231322111031121121021212211231302102312023022223
0310112323212110312010213023231022302210232312102221011012211101211103112130232212030330232302302221
1031121022023112222323121102103230101212102221230223103121031111032321122223102121303010102110030211
1211122122302322222221011030321023112121101012111100330303111311221203222221223212110313230313221113
2231212301022222101011111232212301121121131121211232023110232230230110300212222102302310210230212121
0031122230302211231111123020230213111212303213031021212113022011013112112110203110130111112223121231
3103221012312112031131122123012122322302102110312311221122300331110321111123110123223232121022103011
0122103122101221202303221102303120222121111122222032212101033023123011023211031302102203031102302323
1223210301112212130112012121121211220321123010221302231111202302300331210230311031232122303310230221
0102111013110230303230130303012112212211221123012232210312130230112103032211032322020202322111211011
1111231122332112112023303032303110112113023222312021012121212223121232230231202221212130222303031131
1121023210221101230302230302210111230322310030121122323112122221111022223011030211031103220112212101
1223110112212311022230210230131111210202303103031222221221102212322301002132301231223122211102223111
2101103230110033102211123023221310112122231121223022212221112220221212312302212222221010231110222313
0312310103111222110323210302011031122222221032102210222213121013012121122230123010223112103231022321
1030231111113021312200231111131111221220211222322313021122112322321111222031222311220321130223010031
1212101232121211030130211221211103012211032102210120231221121022223122222103023032210123222221323101
2121131021202312303211011012111110322231210320111211012210303211021210211111021120233102222103022113
1031221103230230230113132310323111200103123013123111122232030110302323111112111212210321003110121121
1103223122103222103321022112121130131322120322300311100223103231122222230321212121223023130311212211
2310102301230221110211221121223211211003103210112231132210322112210301023012111032222320103112121031
0111122111022103103011103212222232112322120103230213210111101110230112320310321102222203112112303231
1031201112223121123131122120103022321021213121023222231112112311223112203032211111002121310122210211
1303113123010303021103030231110301212231221212302221023101110232221210230302231232311112231302231031
0232110302323031211032023023120231010203012122122112303112311001212123221110212222231210110231023221
2221123210221210231221230301213010331030310222110301022321112311003222212312101222030231231201210103
0231002232103211012212223110110311011031113021231213110223122111110220322230312100303102223031111123
1022330102322112322310221031311113123103030312223010322210302312331211010211121231030111021012123201
2301011232010322222103023112123121103121223022222112221223030221023031123010231223211232211111210131
0232323002311022103111122203010032302303220320110321212210311012300303221131012221032221230312231221
0122101110312310301111102130331210230121012223212212222323212321032120231211122221222212212310211011
1221111112030211032303111210223112103212321010122122210022102103211012211123122223002310230122312311
2231232121121031122230112112202322310322223111023102123210312321031123032221222102310231003210210233
0212221211213103221011321121230210231001022123302310301031022103121221203023001231032111121103231021
1222103031221121102323011103012112103112321102230233032311211121222110322301113021203111231230212101
2102311103012031030222323122321122310322210310221022310211023103012211002312322210322303003023121311
0322111122311103111021022221103102103210231032231122103123302122310131121023022132100302310321012113
1220311222112311212231010212310121110211211102221221210222110230111210232301103101232230132011110321
2212110023122112222303123122233103323112123230223012123222232303123112301031102312222211221310312211
2232233222223222222232222222222322222223222222222323222222222223222222232322322232222223222232322223
