0022230010102021200230210222222030201010012010010301022220102100210222022102030022103010200300211003
1101023123311212231023123022223223031123121303103031203023111112113022302321223102302311113031223121
1111103222121122213102101010102021121223122110330310310122111230310102130031210321230231121112222231
1112300301223010121231112311230311212221021132212212111101321211031321221222231023003011032300222303
3121112232202311212222320322231022322211303210222321231112223031103023011022223120310323220131022121
0303110021030311110101023010103101022112232121022212111321200103110302313110023211211022211023110301
0230233103122112123232101123032310321230221103102122312032131121111112221103202230132310223102312231
2212022330101223100301311103102213012220112111121230221210303103032122112310121223202211101322101023
0121102223112102213031032310312030322213122321212221021031021321301102122211211022130122111021131103
1103112222311110130321101211121232102121101012122211121103232212111110302131032322103221112303210321
1110310102231231221011231031212222323101231121102111211230222211231111031211210221230031112222232101
1233031232203011023112223012102212021113011212311113031023102221012311122122322230213203310222102231
1201222102110321230312012321101030303122312110232322311210223010323033222103022212302110122210330213
1031021231212123011030321011131223110122121112210101023012302313022302203110301122130323102112211121
1122312102321102323211022311223100323221031030121112302310230321102121121112231022303221231121123031
1221021102223110012111230123022232210212103103213121102132120211110303103210301222110210203111021101
1023213110221033102312023102302210231023111212222211223221212312112232122111031021111112122322302311
1102102311103221130101203211010123023222312110222132102212122101122022210121213103212111022211023033
2112112231110231211131230123131222222230121231201221122121001132301101031303122322121112301032110301
0321122223032211031211023221203210202223203023032211222311111102112311103030221030311122111221211031
2103102121222103211032302212110212130102110320210110221023113121223031110303023212111211111103230311
0321121222101110231222102122123111223031131012311232013122321211101111111010222221123031231121012211
1011210212111123023022321210301222301203103120231021310301022322112303311311102213221221031211111031
1111112121131221103211023112112222231210321123013122211212102101310122212232112110221010303032312301
1131110303100231101032222121110222212111012102321102132111112230233210230102321023012331030102230231
1103032110233012312302122211312102121131110311011121101230310103022122211110111230322103213222223011
1110221113022322030032222132121230312303112110321223210211123103221210323123212211021110322210212311
2113011320302221103210212101211012110210320313012102131032121130103110101110112123123230220123110111
1122312212312031110211121112211321122123012322311110223302301223112113230321122221022222303221123111
1102122122121011111230231230111023221223122222212233022232212221122122211013020211210102230222230311
1112101101203303132223023211111202223002301022030222302102101023023100112321303111111110222211023103
0301231232130112102221102123232110222330132301231030212231131221102331310212111031231231210123101111
2131022221223121230212310302222310222103102232103222122103211211230023033023231212211103011221031223
2223210212230310223222032230221032211121122211110210223101032111223210301022202310123110312111211021
0222131122210121022210301222101122031211012121231213021131210322222112231120122123210223121103232231
2121103220113013120112312221113221220323121011220110311210232011021102031223221023031012223121021021
0303230023121121213122230211320211223021103131013123031032221311112330303012223022231122221212303011
1022211122303110321201023112211231022312311012322310103102212110302211030310221223023102211031031111
1121011222231112012231120321031011022110112310222031230311031112230121223032212101030310112302301111
1211132211022223102303221021102323302323030212211223021032223122123212102102231232303103121030130313
1031210112230222330110123211112201030221103222111022231101021221022102311121220201112221211223212321
1221031110221022223111100233121012303023102120311122103212231023302123032232211032322102312210121021
1203223231011222211123113002322310230321123210311222122121101102030301222102113222203130112113031103
2122212011131002311021210330210232111001210231030222101211113121213032101121222210121211230322103111
0300322123023110111111112223031022311112303223213021230311122303010301112231010311222110120222310123
0132222301223123231120312210323210211322210222122303023031030103112231230223110231021111212030113201
1210222232221212021211030111022231112222111101022112210311011230320232212102312122231113032303122131
2111030221022121012113223212301012122102331111230122112111323011223022121121032222203321022231201211
1123212102301211111110201030112322230110103111023121123112221111022301212111222222110211210101112111
1102223123032111110323033213110222303123110112302223102301103123102132121112221030331123031232112311
1120221221103131112101210121111022231221113112230222310232122102301222303230103221023021210221322111
1212212212321223311112323103111210122011230122223022032210310321032222232011110211102311031212023231
0121230210223010030302101110121031101112103221010223100231010231102102202311230311121023212101210021
1032211031022323211121231231303103232310320212131102311023131023230323031032211032303300121232123213
1220323110322102231212112210110320210232212121102321231222103222212210301120111212210231232212212121
1012222303022110212103221031232213032221112231121023023012310020321111112303231121031012220321122103
1111022112212311010310103103010321212203122211231212202322113123023111122122011031212321032211101121
2311203122210111131103111110312012102121210230223122122030310102322223202301320303011023022111112303
0110230210111231223121231223222321121212211220222210322301031122222222112032213030103103121111220321
1112112111231222212221220302101023012322111013022131010033223212202221110302322311130302301123013011
1111221112103012222212223031111301321020332320322223111300222310030123123102022303223110033012110321
1112203103122322210310222301112232223103022221021002321031022111303221012223102232202113102322312211
1230123110302022310123022312310222022130230213111110103212221121032103122201212202121310110202322231
2103210331032302213210210230211101101223023210303311130231011223102121302112110231103031311122201023
0310310211210122130111031212112311112221222123222103223023113010301212101130311021121211032302113103
2230232322111221203103103010310231110102121222110322222302310311032123131103031231210111222203102321
0212210212212212123121110332111211111231222210312210222230110123023210303112223003031231022130322221
1002311122130231222311230101123031131221022112122223202213113122302212230321022130311201210303030223
3110231021223202230223221230300303210210310321222102232221121220111022231023101212103032111010223021
0332211111220230212102213011213031031031212103022302222121212213112210223210331030321212311311222111
0220323121021023010310310310230310323112211230300310211211012122320132221032221223012101032112210311
2111022212303110332231031031023023022310121103032223121032321220213222011101023030322311211121031023
1032230230223212210011223103211120310103211112302212103221212212110022332311221103201212112211211211
2302103103102230123121201110112223223030123122122121122212122221123302220211103222112123122123223031
0111231030111023102311031131121022221123002223102311222221102112102230212312110221231222101102221121
1230023023111103230102323223211022211101321020310012222123103103112031222230311212102221131110103221
0123222101311120303111020301030301031231021213033102211101030302321012222112123030310111221231310031
1222221312121211031223212112323031231012311110301130121111211110031320223102321011203102232101033103
1201211030303031102030111230021012212321022321212303213232111211303003010310203112121121022331210321
2232232112121210311103112223111321110103223012210231030222312123030310303212301122311111210221031023
0210101223222312232310322210311011031230210321232210321020121102223031030122131101103122311013102303
1223111010220230222112220323102323223023123212102231011103303223011111303212223112310302112301112221
0122231123023012121112212222023022222320222210321011111122232010311112122122222302232231230111121021
1222212301302303211230222301102301022023022232223112323102202311031210211221200310012022103131122311
2122122232122122122212210231310111211210230221002321021102321031210232120232111031122303231211222111
1221021003210321203022211222231232121111023212321031212310211303113022323022331213022101022121210311
0031111320312221010310131022211021103113120222103102321231032110120302222302100321101112310211012123
1223122212120303112111212302033211112121210122112223023023102113221030103011231011112310111031123101
2221011030212110323111110101301032321011033221121021102301230322213101030310211123301111211103101111
0231311212111232222311031132111102223111221011212312310230103201030311303112323120131112111321111111
1012230122322100221211223221111122110131023123030030032211322111212130230122222223103110311011111111
2300223300221132112212221203231221123212322110311223210132222131011210223210101030321223231111111231
0113022231013102310121212110023012102220222303023022123210221103121111012231111222223022223110312221
1230302230322301223222210311102321231023012211102101222123011110312111122211232221030102222323030231
1011010212101031021021112111232212212302322111123031030303111211203113021212103023023232201020322211
2322311032231232231103023111022102122110222311221211211030312112120321232122321122202222131123022123
0101231102122222221112302311110321003232021210031232111103122311212303022310021221030221223202301021
1112211121222122221122232112322213130101230111222222122121100112110111011023122303212111022130231231
1231031223021210213103020322221222303231013112230122301231031321123112311110302112230311103223023021
3222223222232223222322232222222222232222322322223222232223232222223222232232223222223222322222222323
