0021002221002212222202210221021201222220230201202122010102012021022120102210212022222110102203020121
3111122213110310222230310212322112210221023112111222313110322311012223230111121022101031110110303221
0303022310310223022021032122201232111223210321230222121211210211301010211123023210111303233122310103
2112301031033021221211221210131021110102211023212101032112123032112312113023120131112232220101031311
0322231103221211031113023031223122311230103120211131201121101101110230321021211211322101011113210231
0212011122112231103122302312110222230303130303223222111211231032330212111230323110201232311110112211
2110312210321023031022032210312102303031223102221022311112103221012322232210022112312101031111230111
0312110232211221122301101012110302223100230122111211032321110232321010210231101121032111101230123111
1030312211030103102231212330303230222312223221212231102223311021012312112111231103221131131013101023
1210120321211111121032110223112012122112220231030203232022230303120310321122231121023103221121231301
1031213022323112223022312102122321021121021021212302202302103122312123023210101303212230223103012211
3103122310222322210301203110211023303212311122122130230223110221201023222121111030122223021122322131
0321222032101201012232110311031222230030223101302223012102311011033222203213111121102102303222210301
2112102101232111130103111231223022203103010312230210310310123132102210110122311103101110110210112231
0301121110301113223122132211022222321311112030212110131123201102321111231221013230331033223123122111
0112303112231120101021210110310210101031121223110313221220112110210311023011122223011302102301210303
1122232310232223311232111231211221231211112212111121012101311111111031210132310030112030310111031221
3102210230220302232222323022231013012321221121112211112233032123031212031302223223121103211232102211
0121123212031030030022030230210321122211103031223032321020301230312121122210230101111310123021121031
1111002103103103223212303010311212302122310301022303023013031023101111222123023111102231221103123211
1211321102310323010102230323032210230302231033212210310321112320231111022101211231110223212312222231
1232211130211010311130212101122113012110211221022231030232212013023211301232112031131222022122122223
0222231223111111123103030331101121122123032212230223023010122321210231032211121023212221011211102221
1010210211032312103231223201112303101223222212103021121123102112211212310231223222212211110121230211
1110322112102122322021022033110121231022203030312112223210321102232210231102021203030211311231031031
2311021321303022222311230102303212212221121122121222102232211122222321011223210230301232112023103121
1033212212230310022231023110230121030122231222111203122210123222210223112221033011013001101222121221
1222230122212103210223101112223212303221012030312101220311221001123022321011210312310311131010312121
0222211222110322123001132312220110121012320303010332223033012310223210112312103120110311211112221211
0210223201123221221311102122211123223321011030132101021222122231022111222322321031311032310311010311
1112210132222210011031111222113202210211123121221232312222302123103110102210032101031222233030323033
2112231222221033112303022301122102123223221212302100222102121210321233223031222311112210221213021021
1122223001011221110310310232101123102220303122121113021311223112210022221103010113210312122110303301
1100230312312212321031031022311102310212230201211121101031002122113022111221311121032122101232110031
1112211121230210213211103302232310123032103032111210311101112302321221102212211211221203110222313103
1110111011012131030230310231020211201101110310323033031132110232023223130121032110032210313012222311
1113122312321223103023032212211231113231230122221101103101123022302221223011203113002311121122221121
0310210111021011110321210122132202302103013222111110323231222322032032221312110321321032112230103031
1223111121112123112212111011222130123022322221111113020103021002320102203032132111021221122103232103
1012211123102302310321123121203203221102122211103110231112101122103310121221102302322303102110022111
2322111210321110232222302312210130223311210122321123021321113121122031212211232223022221121111221321
0210311223031112222102121101031203022110323202121102323003302301221103121112102101030213103312112211
1232131021023122221230303232112130223223022123211120101130121031023121211110121232103122230111101123
1003103111120202230032210221223103010210301221031211231223103111102232111111231021310101023032232211
0322301111210322211102112122221030323123032103010311210230321103123001211023023112123213110302210311
2120112231031010231311231212203212101022301232313032112211222130302311031302302310302230303030230231
1211121023213123012121202322121203111211011220121101212112210303030113112230312212230112130311012211
0311123100321210322232102023112110312230310223211231222121033030323110302101030101203101223012310111
0121222132031012102201130102301111212221113021030231012211221211002311210331211112231232102310231321
1223012301212321230112221321013132110212122303023023122130212103130111031012123101220222310111222203
1102322232110103103130211023130301123032120121102322103210123121211232312302302332212122231212210111
1122221010323112121223111101023032302221023303121202302111221212212222010230230022101222103110103121
2302223112221022212102111111100310103011301032211030103113022110122301322303003301131021110231110311
0230230322011301223112311112312123030311030301031103130121221111210112102110130231101121110303112123
1022103221111032222310113121223101103032311031231111211031011123123121121223303221231211231031121221
1230322221132310102223122303022311111210103211023110111302323222221223103102230212103111223110311011
0211020303222203230101222230222231310311103031210231110230102222223021230122211121122312102303222311
1112212223022112203232211012102111032113230312231201313023102221022211013102212211221031121121010131
2321103021110322232222112321121112302110103021031031030303130121302212322121031031103211103012323211
0101230312230221022222122211103102230323230103103103212121103212110230120231023211110112232302103031
1231022230211023110221212112230321023202213121210310221211230310311023213023301031223210210232210301
0213110223113101123023030121023023210230321212111031102310203030233221121021032301021111111021231031
2121111222222312302102303111221122211210211031123301230232310311022103011212212113101232111212212303
1111212222103012031112221112121102123031032321102033023100232103210311123210121110313010311030120121
1210103022322310322310223211212121221223100221231102321031022322311031222131103111122323031103031103
2111310310202230210123221032111032212101112212301121023112320101032310023211120322121021010312303111
0312231222301103123202223210112302231231030230232311021221023112301011102231103012223103111010121311
2110212222131032201030222111322112203011211023023011212031010311032323232221121122222321311323012121
0323120223103222231220230112023110122311212322022311110303312230322010222103123221102211032101111223
0210223021101021221013011310301111222232112021210111212221031011022323201231222103230103101111112203
2123010311132112213110311031031230222203121103231112130212303123022222130030010302223121112311122101
1102111211201221110323012221112222102030322302223221211030110303102121211223132122302303122232302331
1130311032131210312101130103030221311103010110110212123121231101111222112023101222230110321021030221
1210131221210111023111223123103023031122323111122302221210103112312210321102312012223110212212301211
0311103003033111222312203222311120303101203131222123011031232030120103011110231121022112321032112121
2111121130301122102230130030231211221112121211003102313011201211213122311303011103021322103210111211
0311211023211201110211223211030232101112211031310301121112231111030301232122321121031021231031303031
0232111222112131102311210211211020313110111223012111203302103023223032221010103111303210110322030311
2212312110301211110120231031031112121111122221111132122121112102221110223123110312030231112221103211
0230101111230123131213011303211221103111102232311222302311121310232312211121130122302231211011310231
2223111112213201023221103032032123101123102222230202110103112111002210110221211210230223110311030223
2010331121030131302212310302301202332222311010221031123123103230322111113013032111023003033031213021
0311003103121103010122131010232210222222110323011212221222302212121113110322303123122322101212122231
1032130321223230331212223131030130222102312302312121023022303010301110310210030321221021232103222103
1302303010102102210322120103103223021110102230232303121022110311211123032313212222112303023210222321
2121110313223112111021211122122110303323130112222231212302311232231222320110122011202312100312222211
0112112110221222323012231011101212121021203120222230230122232220111030023123101110110230312230102111
1203122311212222021321211123033031211112121212010223023222100223231103121221231123112110112013121231
0130223032222101112210103102301210312301120321322212102222233021011023210232103122310311110322212101
1223021203022311211031123122112231030111211012210310303021010312323301030101230102230111231102103111
2221212102222312123103101003112221103112111122230232130312312101002112323031011230213103221103210311
0222110323022111210321231310322203111121231210231021103220310312311110101031123212122322103230131031
3021312222122232112122103031220310321223222311023103112023012122111103231303222221221210230211223011
0311012222301220121101321103023032122022222231120321121210311122311111012102220112212123023011220311
1023130102112211111032103212210301210301222222223012303031111222230311122310211222111222301132212311
1110223223221111111103102102231032233032222221010322230303110022111121221031032101121030031200322231
1122223021012311211230303130103210210303021023123023022112223301211103103231210311211223212311002111
1210102312310232131023030303110123032121212102301022302322222232131022301023030231231010030233112231
1123230221031002303101112110323121101222112312031230122012010121103230132223103212103123103010310103
3222222232223322222332223232222223232222322222322223222322323223222223222222322223222322322322323223
